#########
#00000T0#
#0000000#
#0000000#
#0000000#
#0##0000#
#00#0000#
#00#0000#
#########
*{"P":{"position":{"x":7,"y":1}},"B":[{"position":{"x":2,"y":2},"id":1}]}
