#########
#000000T#
#0000000#
#0000000#
#0000000#
#0000000#
#0000000#
#0000000#
#########
*{"P":{"position":{"x":1,"y":1}},"B":[{"position":{"x":1,"y":2},"id":1}]}

