############
#0##0000000#
#0000000000#
##00000##TT#
###0########
###00000000#
#0000000000#
#0000000000#
############
*{"P":{"position":{"x":7,"y":10}},"B":[{"position":{"x":5,"y":9},"id":1},{"position":{"x":6,"y":9},"id":2}]}
